1111111111111
1C010000000C1
100C011111001
1P0011E0000E1
1111111111111
